1111111111111111111111111
1000000000000C00000000111
1000000000000000000000101
10000P0010000000000000011
1000000000000000000000001
100000000000000000E000001
1111111111111111111111111
