1111111111111111111111111
100000000010C010000000001
1000000000101110000000001
1000000010000000000000001
10P0000000000000C00000001
1000000000000000000E00001
1111111111111111111111111
