11111111111111111
11CCCCCC0CCCCCCC1
1CCCCCCCCCCCCECC1
1CCCCCCPCCCCCCCC1
1CCCCCCCCCCCCCCC1
11111111111111111
