11111111111111111
11PCCCCCC1E0000C1
10000000000000001
11111111111111111
